################
#              #
# ####    #### #
# #          # #
# #    #     # #
#      #       #
#       #      #
# #     #    # #
# #          # #
# ####    #### #
#              #
################
