████████████████
█       █      █
█ ████    ████ █
█ █     █    █ █
█ █          █ █
█   █  █  █    █
█   █     █    █
█ █    █     █ █
█ █      █   █ █
█ ████    ████ █
█       █      █
████████████████
