████████████████
█       █      █
█ ██ ██   ██ █ █
█ █   █ █  █ █ █
█ █ ██       ███
█   █  █  █    █
█   █    ██ ██ █
█ █   ██    ██ █
█ █      █   █ █
█ ████ █  ████ █
█       █      █
████████████████
