████████████████
█       █      █
█ █████    ███ █
█ █   █ ████ █ █
█ █ ██   █   ███
█   █  █  █    █
█   █    █  █  █
█ █   ██   █   █
█ █      █  █  █
█ ████ █  ████ █
█       █      █
████████████████
